FE8 - Snowy Bern
17 25
67 770 770 770 67 705 67 193 194 195 67 833 834 835 67 67 67 67 642 643 67 67 67 67 67
100 833 834 835 736 737 67 642 643 67 67 865 866 867 67 67 67 67 674 675 67 193 196 67 100
673 865 866 867 768 769 67 674 675 67 67 897 898 899 67 192 67 67 67 67 67 193 196 67 130
67 897 32 899 67 67 67 67 67 67 67 67 67 67 642 643 192 67 67 130 67 193 196 100 67
67 100 67 67 100 130 67 67 67 67 130 66 67 67 674 675 67 67 67 833 834 835 67 67 67
67 67 66 132 67 67 642 643 67 67 67 67 66 67 67 67 130 67 67 865 866 867 67 67 67
193 196 67 66 67 67 674 675 67 66 131 67 67 131 66 67 67 67 67 897 898 899 67 67 193
67 67 67 67 67 130 67 67 67 66 67 67 67 67 67 67 642 643 67 67 67 67 67 67 193
100 833 834 835 67 66 67 67 67 67 67 640 641 67 67 67 674 675 67 192 67 642 643 67 67
67 865 866 867 67 100 67 67 67 66 67 736 67 643 67 67 67 67 192 192 67 674 675 67 67
67 897 898 899 67 66 67 642 643 67 67 674 67 675 67 67 67 67 192 67 67 67 67 67 67
67 67 67 67 67 67 67 674 675 67 67 67 740 67 67 67 67 67 67 67 833 834 835 67 67
100 67 67 67 67 67 67 67 67 67 67 67 130 67 67 130 131 67 67 67 865 866 867 67 67
132 67 67 833 834 835 67 67 67 130 67 67 67 165 67 130 67 67 642 643 897 898 899 67 67
67 67 67 865 866 867 67 67 67 67 67 130 67 67 67 67 67 67 674 675 67 67 67 67 67
195 196 67 897 898 899 67 67 67 67 165 130 67 67 67 192 67 67 67 67 67 130 67 67 67
193 192 67 67 130 67 67 130 165 67 67 67 67 67 193 195 196 67 67 67 67 67 67 192 67
