style -   - 006C6D6E
20 19
684 685 686 198 197 229 198 131 198 198 131 198 197 229 131 131 198 197 131
684 685 686 131 131 197 131 131 572 198 131 131 131 198 131 131 131 229 198
684 686 198 131 198 198 572 596 671 630 572 198 198 131 131 131 198 197 572
684 686 572 572 572 596 671 634 634 671 671 630 131 131 131 131 198 631 703
197 198 604 671 671 671 605 131 131 628 671 671 602 630 131 131 631 703 629
130 131 628 671 671 671 605 131 131 131 636 671 671 629 131 631 703 629 198
198 198 131 604 671 671 671 630 131 131 604 671 605 131 572 604 605 131 131
197 131 198 628 634 671 671 605 131 631 671 671 605 131 604 703 703 597 131
198 131 198 131 131 599 634 671 602 671 671 635 598 198 628 703 703 703 597
131 131 131 131 198 198 131 636 671 671 605 131 131 198 131 628 703 703 703
131 131 131 131 131 197 955 2 2 2 2 927 131 131 130 131 628 634 703
131 131 131 131 198 131 1018 2 2 2 2 991 131 131 131 131 131 131 628
198 131 131 198 572 572 596 671 671 671 605 131 198 198 131 131 131 131 131
197 131 131 198 604 671 671 671 634 634 671 630 572 131 131 131 131 131 131
229 198 198 572 628 671 671 605 131 131 636 671 671 597 131 131 631 630 131
686 229 197 604 602 671 671 671 602 602 671 671 671 605 131 631 703 703 597
684 685 686 628 671 671 671 671 634 634 671 671 671 598 131 599 703 703 703
684 686 131 198 628 634 635 629 131 131 628 635 629 131 131 131 628 634 703
684 686 198 131 198 131 198 131 131 198 198 131 131 198 131 131 131 198 636
684 686 197 131 131 198 197 131 131 131 197 198 131 131 198 131 198 131 686
